####################
#                  #
#     B            #
#                  #
#   M              #
#                  #
#                  #
#                  #
#                  #
#        S         #
#                  #
#         X        #
#                  #
#                  #
#                  #
#                  #
#               F  #
#  W               #
#                  #
####################